id,transaction,balance,candle_id,price,is_closed,cause,accuracy,result,time
0.0,1000.0,1000.0,0.0,1000.0,1.0,money,0.0,,2025-01-19 20:26:00.631109
1.0,-136.05,863.95,1545.0,136.0,1.0,stop_loss,0.8016094106354477,/,2025-01-16 07:06:00+00:00
2.0,-135.9,728.05,1546.0,135.85,1.0,take_profit,0.8151062551012893,/,2025-01-16 07:08:00+00:00
3.0,-136.07,591.98,1548.0,136.02,1.0,stop_loss,0.8049508012389877,/,2025-01-16 07:12:00+00:00
2.0,135.52,728.05,1551.0,136.12,1.0,take_profit,,+,2025-01-16 07:18:00+00:00
1.0,135.67,863.72,1552.0,135.73,1.0,stop_loss,,-,2025-01-16 07:20:00+00:00
3.0,135.69,999.41,1552.0,135.75,1.0,stop_loss,,-,2025-01-16 07:20:00+00:00
